10,15,3,2
++++++++++++++++++++++++++++++
+             +++++++++      +
+ ++++++++++++++        ++++++
+ +s++        ++ +++++++++++++
+ +    ++++++ ++          ++++
+ ++++ +  +++ +++++++++++ ++++
+      ++     +++++++++++ ++++
+++++++++++ +++++++++++++ ++++
+++           +++++++++++    +
++++++++++++++++++++++++++++++
++++++++++++++++++++++++++++++
+ +++++ +++   ++++++++++++ + +
+ +   + +++ ++++    ++++++++++
+ + + + +++ ++++++++++++++++++
+ + + + +++ +++++++  +++++++++
+ + +++ +++ ++++++++++++++++++
+ +     +++ +++++++++ ++++ +++
+ +++++++++ ++++++++++++++++++
+           ++++    ++       +
++++++++++++++++++++++++++++++
++++++++++++++++++++++++++++++
+++++++ ++++++++++++++    ++++
+++++++ +++++++++     ++++++++
+++++++ +++++++++ ++++++++++++
+             +++ +++ +++  g++
+++++++ +++++++++ ++++++++++++
+++++++ +++++++++ ++++++++++++
+++++++ +++++++++ ++++++++++++
+++++++ +++++++++ +    +++++++
++++++++++++++++++++++++++++++

